
10tips=10 tips (video)
about=About
actualSize=Actual size
add=Add
addGroup=Add a group
addImages=Add images
addImageUrl=Add url of a image
addKnowledgePoint=[]
addLayer=Add layer
addLearningActivity=[]
addMaterial=Add materials
addProperty=Add property
addRule=Add rule
addSkill=[]
addTask=[]
addThing=[]
addToExistingDrawing=Add to existing drawing
addWaypoint=Add waypoint
advanced=Advanced
align=Align
alignment=Alignment
all=[]
allChangesLost=All changes will be lost!
allChangesSaved=All changes have been saved
allChangesSavedInDrive=All changes have been saved in drive
allCommentDeleted=All comments of the task:{1} have been deleted!
allowPopups=Allow popups
alreadyConnected=Nodes already connected
and=And
angle=Angle
antiVirusSoftware=Antivirus sofrware
applicableUsers=[]
apply=Apply
areYouSure=Are you sure?
arrange=Arrange
arrow=Arrow
arrows=Arrows
asNew=As new
assignLater=[]
assignRole=Assign roles
atlas=Atlas
authorizationRequired= Authorization required
authorize=Authorize
authorizeThisAppIn=Authorize this app in
authorizing=Authorizing
automatic=Automatic
autosave=Autosave
autosize=Autosize
background=Background
backgroundColor=Background color
backgroundImage=Background image
basic=Basic
basicInfo=Basic information
beginner=[]
bindTypicalWorkTask=[]
blank=[]
blankDiagram=Blank diagram
blankDrawing=Blank drawing
block=Block
blockquote=Blockquote
boardIParticipated=[]
bold=Bold
borderColor=Border color
borderWidth=Borderwidth
bottom=Bottom
bottomAlign=Bottom align
bpmnEvents=BPMN events
bpmnGateways=BPMN gateways
bpmnOthers=BPMN others
bpmnParticipants=BPMN participants
bpmnSubprocesses=BPMN sub-processes
bpmnTasks=BPMN tasks
browser=Browser
bulletedList=Bulleted list
businessprocess=Business flowchart
cancel=Cancel
cancelDelete=Cancel the deletion
cancelSharing=[]
cannotLoad=Failed to load, try again
cannotLogin=Failed to login, try again
cannotOpenFile=Cannot open file
center=Center
change=Change
changeOrientation=Change orientation
changesNotSaved=Changes haven't been saved
changeUser=Change user
chapterDescr=Chapter Description
charts=Charts
chatJoined=New chat joined
chatLeft=One chat left
chatWindowTitle=Chat window title
chooseAnOption=Choose an option
chooseCondition=Choose a condition
chromeApp=Chrome APP
circle=Circle
classic=Classic
clearDefaultStyle=Clear default style
clearWaypoints=Clear waypoints
clickToDelete=click to delete me!
clipart=Clipart
close=Close
collaborator=Collaborator
collaborators=Collaborators
collapse-expand=Collapse/Expand
collapse=Collapse
collapsible=Collapsible
colorPicker=[]
comment=Comment
commentsNotes= Comments notes
completeDataPlease=[]
conditionControl=[]
connect=Connect
connecting=Connecting
connection=Connection
connectionPoints=Connection points
connectWithDrive=Connect with drive
constrainProportions=Constrain proportions
containsValidationErrors=Contains validation errors
contentOfTask=[]
copy=Copy
copyConnect=Copy on connect
copyOf=Back-up
copyOfDrawing=Copy the drawing
copyStyle=Copy the style
courseModel=[]
create=Create
createInstance=Create a instance
createNewDiagram=Create a new Diagram
createNewFile=Create a new file
createOrEditRichTextsModel=Create/edit rich text model
createRevision=Create revision
createRichTextsModel=Create rich text model
createShape=Create shape
creator=Creator
current=Current
currentGraphDoesNotExistAnymore=current graph doesn't exist anymore!
curved=Curved
custom=Custom
cut=Cut
dashed=Dashed
dataDescription=[]
dataName=[]
DataObject=Data Object
dataRecovery=Data recovery
day=[]
days=Days
decideLater=Decide later
decreaseIndent=Descrease indent
default=Default
delete=Delete
deleteColumn=Delete column
deletedFile=Deleted file
deleteFile=Delete file
deleteLearningRes=delete learning resource
deleteRow=Delete row
DeleteSuccess=Delete success
deleteTheseFile=Delete these files
deleteThisFile=Do you really want to put the file into Recycle Bin?
deleteTrashFile=Delete trash file
describeInstance=Describe instance
description=Description
detailDescription=Detail description
detailsOfTask=[]
detailsView=Details view
device=Device
diagram=Diagram
diagramLocked=Diagram locked
diagramName=Diagram name
diamond=Diamond
diamondThin=Diamond (thin)
didYouKnow=Did you know
direction=Direction
discardChangesAndReconnect=Discard changes and reconnect
disconnected=Disconnected
discuss=[]
distribute=Distribute
divider=Divider
documentProperties=Document properties
done=Done
dotted=Dotted
doubleClickOrientation=Doubleclick to change orientation
doubleClickTooltip=Double click tooltip
download=Download
downloadAs=Download as
dragImagesHere=Drag images here
dragUrlsHere=Drag urls here
draw.io=Draw.io
drawing=Drawing{1}
drawingBoard=[]
drawingEmpty=Drawing is empty
drawingTooLarge=Drawing is too large
dropbox=Dropbox
duplicate=Duplicate
east=East
eceditor=Eceditor
edit=Edit
editChapterProperty=Edit chapter property
editData=Edit data
editExam=Edit exam
editGeometry=Edit geometry
editImage=Edit image
editImageUrl=Edit image url
editing=[]
editInstance=Edit instance
editLink=Edit link
editMaterialOnline=[]
editObjectData=Edit object data
editProperty=Edit property
editShape=Edit shape
editSource=Edit source
editStudyResource=Edit study resource
editStyle=Edit style
editSubProcess=Edit sub process
editSuccessfully=[]
editText=Edit text
editTooltip=Edit tooltip
editType=[]
embed=Embed
embedNotice=Embed notice
emptyName=[]
endCondition=End condition
endTime=End time
engineering=Engineering
ensureDataSaved=Ensure data saved
enterGroup=Enter group
enterName=Enter name
enterPropertyName=Enter property name
enterValue=Enter value
entityRelation=Entity Relation
equal=Equal
error=Error
errorInShape=Error in shape
errorLoadingFile=Error in loading file
errorRenamingFile=Error in renaming file
errorRenamingFileForbidden=Error, renaming file forbidden
errorRenamingFileNotFound=Error, renaming file not found
errorSavingFile=Error in saving file
errorSavingFileForbidden=Error, saving file forbidden
errorSavingFileNotFound=Error, saving file not found
errorSavingFileUnknown=Error, saving file unknown
errorSendingFeedback=Error sending feedback
ExclusiveGateway=Exclusive Gateway
exit=Exit
exitGroup=Exit Group
expand=Expand
expert=[]
export=Export
exportAs=Export as
failedToSaveTryReconnect=Failed to save try reconnect
failToEdit=[]
false=false
featureRequest=Feature request
feedback=Feedback
feedbackSent=Feedback sent
file=File
fileDescription=[]
fileExists=File exists
fileManager=File manager
filename=Filename
fileNameAsc=File name asc
fileNameDesc=File name desc
fileNotFound=File not found
fileNotFoundOrDenied=File not found or denied
fileNotLoaded=File not loaded
fileNotSaved=File not saved
fileOpenLocation=File open location
fileWillBeSavedInAppFolder=File will be saved in app folder
fill=Fill
fillColor=Fill color
fit=Fit
fitContainer=Fit container
fitIntoContainer=Fit into container
fitPage=One page
fitPageWidth=Page width
fitTwoPages=Two pages
fitWindow=Fit window
flip=Flip
flipH=Flip horizontal
flipV=Flip vertical
flowcharts=Flowcharts
font=Font
fontColor=Font color
fontFamily=Font family
fontSize=Font size
forbidden=Forbidden
format=Format
formatGif=Format gif
formatHtmlEmbedded=Format html embedded
formatJpg=Format jpg
formatPanel=Format panel
formatPdf=Format pdf
formatPng=Format png
formatPngEmbedded=Format png embedded
formatSvg=Format svg
formatSvgEmbedded=Format svg embedded
formatted=Formatted
formattedText=Formatted text
formatXmlCompressed=Format xml compressed
formatXmlPlain=Format xml plain
formModel=Form model
forum=Forum
fromDB=[]
fromTemplate=From template
fromTemplateUrl=From template url
fromText=From text
general=General
generalCourseDesignTool=[]
GeneralEnd=General End
GeneralStart=General Start
getSkillBtn=Get skill button
glass=Glass
global=Global
googleDocs=Google docs
googleDrive=Google drive
googleDriveMissing=Google drive missing
googleGadget=Google gadget
googleImages=Google images
googlePlus=Google plus
googleSites=Google sites
gradient=Gradient
gradientColor=Color
grid=Grid
gridSize=Grid size
group=Group
guides=Guides
hateApp=Hate app
heading=Heading
height=Height
help=Help
helpTranslate=Help translate
hidden=Hidden
hide=Hide
hideIt=Hide {1}
home=Home
horizontal=Horizontal
horizontalFlow=Horizontal flow
horizontalTree=Horizontal tree
hour=[]
hours=Hours
html=HTML
htmlText=Html text
iframe=Iframe
ignore=Ignore
image=Image
images=Images
imageSearch=Image search
import=Import
importedFile=[]
importFrom=Import from
includeCopyOfMyDiagram=Include copy of my diagram
InclusiveGateway=Inclusive Gateway
incorrectMaterialFormat=[]
increaseIndent=Increase indent
inline=Inline
inputKnowledgePointsName=[]
inputMaterialName=[]
inputSkillName=[]
insert=Insert
insertColumnAfter=Insert column right
insertColumnBefore=Insert column left
insertEllipse=Insert ellipse
insertHorizontalRule=Insert horizontal rule
insertImage=Insert image
inserting=Inserting
insertLink=Insert link
insertMaterial=[]
insertRectangle=Insert rectangle
insertRowAfter=Insert row below
insertRowBefore=Insert row above
insertText=Insert text
instance=[]
instanceDescription=Instance description
instanceFile=[]
instanceManager=Instance manager
instanceName=Instance's name
invalidName=Invalid name
invalidOrMissingFile=Invalid or missing file
invalidParameters=invalid parameters...
invite=[]
isAlreadyBoardMember=[]
italic=Italic
ItIsNotAllowedToSaveTheGraphAtTheCurrentContext=It is not allowed to save the graph at the current context
justNow=[]
kennedy=Kennedy
knowledgPoint=Knowledge Point
kpExam=Knowledge Point Exam
label=Label
landscape=Landscape
lane=Lane
laneColor=Lanecolor
language=Language
lastChange=Last change
layer=Layer
layers=Layers
layout=Layout
lChatHistoryLeftSaveItBeforeLeaving=[]
lDoTheseThingsBeforeCreatingTheFile=[]
lDuplicateSelectedConditionPleaseCheck=[]
learningEnvir=Learning envir
learningGuide=[]
learningResEdit=learning resource edit
learningResManager=learning resource manager
learningResSearch=learning resource searching
left=Left
leftAlign=Left align
leftToRight=Left to right
lessThanAMinute=Less than a minute
lFailToGetVMTypeChooseOtherToolTemporarily=[]
line=Line
lineend=Line end
linestart=Line start
linewidth=Linewidth
link=Link
loading=Loading
lockUnlock=Lock/Unlock
loggedOut=Logged out
login=[]
logout=Logout
loveApp=Love app
lPleaseLoginAgain=Sorry! you are offline, please {1} This page will be available when you're online
lSystemDoesNotSupportTheFormatConvertAndReupload=[]
machineDataRecovery=Machine data recovery
mainEmbedNotice=Main embed notice
makeCopy=Make a copy
manageInstance=Manage instances
manageRichTextsModel=Manage rich texts model
manual=Manual
manualDataRecovery=Manual data recovery
master=[]
materialFile=[]
materialsName=Materials' name
mathematicalTypesetting=Mathematical typesetting
maximum=Maximum
member=Member
merge=Merge
message=[]
middle=Middle
mindmaps=Mindmaps
minute=Minute
minutes=Minutes
misc=Misc
missingExam=[]
missingFileInInputFile=[]
missingFileInPreviousContent=[]
missingInputWay=[]
missingIsOutputNecessary=[]
missingOutputLearningOutcomes=[]
missingPreviousContent=[]
missingRole=[]
missingThingsName=[]
missingTool=[]
missingVMType=[]
mockups=Mockups
months=Months
more=More
moreResults=More results
moreShapes=More shapes
move=Move
moveDown=[]
moveSelectionTo=Move selection to {1}
moveToFolder=Move to folder
moveUp=[]
moving=Moving
multiple=Multiple
MultipleCatchingGateway=Multiple Catching Gateway
multiRoleLearning=[]
mxResources.get('') +=[]
mxResources.get()=[]
name=Name
navigation=Navigation
networkdiagrams=Networkdiagrams
new=New
newLibrary=New library
noAvailableCondition=[]
noAvailableObject=[]
noColor=No color
nofile=No file
noFiles=No files
noFileSelected=No file selected
noMoreResults=No more results
none=None
noNextTask=No next task anymore
noOtherViewers=No other viewers
noPlugins=No plugins
noRecentOpen=No recent open
noResponse=No response
noResultsFor=No results for
noRevisions=No revisions
normal=Normal
north=North
notADiagramFile=Not a diagram file
notALibraryFile=Not a library file
notAvailable=Not available
notConnected=Not connected
note=Note
nothingIsSelected=Nothing is selected
notUsingService=Not using service
notYetSupported=Not yet supported.
nullDescription=[]
nullInput=[]
nullInstanceName=Null instance name
nullKnowledgeInput=Null knowledge input
nullSkillInput=Null skill input
numberedList=Numbered list
offline=Offline
ok=OK
okToCancelSharing=[]
okToDelete=[]
oneDrive=One drive
opacity=Opacity
open=Open
openArrow=Open arrow
openExistingDiagram=Open existing diagram
openFile=Open file
openFrom=Open from
openInNewWindow=Open in new window
openInThisWindow=Open in this window
openIt=Open it
openLibraryFrom=Open library from
openLink=Open link
openMaximumnFile=should not open more than 10 each time
openSupported=Supported format is .XML files saved from this software
OPLECourseDesignTool=[]
options=Options
or=Or
organic=Organic
orthogonal=Orthogonal
other=Other
otherModel=Other model
otherViewer=Other viewer
otherViewers=Other viewers
outline=Outline
outputLearningOutcomes=[]
oval=Oval
pages=Pages
pageScale=Page scale
pageSetup=Page setup
pageView=Page view
pan=Pan
panTooltip=Pan tooltip
paperSize=Paper size
ParallelGateway=Parallel Gateway
participant=[]
paste=Paste
pasteHere=Paste here
pasteStyle=Paste style
pattern=Pattern
performRole=[]
perimeter=Perimeter
pleaseChooseAFile!=Please choose a file!
pleaseChooseAFile=Please choose a file
pleaseChooseAMaterial=[]
pleaseChooseCondition=Please choose condition
plugins=Plugins
pluginUrl=Plugin url
pluginWarning=Plugin warning
plusTooltip=Click and drag to connect, click to clone
pool=Pool
portrait=Portrait
position=Position
posterPrint=Poster print
preferences=Preferences
preview=Preview
previewExam=Preview exam
previousContent=[]
primaryUser=[]
print=Print
properties=Properties
publicDiagramUrl=Public diagram url
published=[]
publishTheCourse=Publish the course
publishTheCourseToPlayer=[]
radialTree=Radial tree
readOnly=Read only
realtimeTimeout=Realtime timeout
reason=[]
recentOpen=Recent open
reconnecting=Reconnecting
redirectToPro=Redirect to pro
redo=Redo
refresh=Refresh
relatedInfo=Related information
relatedKnowledgPoint=Related knowledge Point
relatedSkill=Related skill
rememberMe=Remember me
rememberThisSetting=Remember this setting
removeFormat=Clear formatting
removeFromGroup=Remove from group
removeIt=Remove {1}
removeWaypoint=Remove waypoint
rename=Rename
renamed=Renamed
renameFile=Rename file
renameIt=Rename {1}
renameLearningRes=Rename learning res
renaming=Renaming
replace={1} already exists. Do you want to replace it?
replaceExistingDrawing=Replace existing drawing
representationElem=Representation elem
required=Required
reset=Reset
resize=Resize
restartForChangeRequired=Restart for change required
restore=Restore
restoreFile=Restore file
restoreState=Restore state
restoring=Restoring
retryingIn=Retrying in
retryingLoad=Retrying load
retryingLogin=Retrying login
return1=Return1
reuseExistFile=Reuse exist file
revisionHistory=Revision history
right=Right
rightAlign=Right align
rightToLeft=Right to left
rotate=Rotate
rotateTooltip=Click and drag to rotate, click to turn by 90 degrees
rotation=Rotation
rounded=Rounded
run=Run
runProcess=Run process
save=Save
saveAndExit=Save and exit
saveAs=Save as
saved=Saved
saveDiagramsTo=Save diagrams to
saveLearningActivitySuccessfully=[]
saveSuccess=Save success
saving=Saving
scrollbars=Scrollbars
search=Search
selectAll=Select all
selected=[]
selectEdges=Select edges
selectedTemplate=[]
selectFont=Select a font
selectionCannotBeChange=[]
selectVertices=Select vertices
semantics=Semantics
sendEmail=[]
sendMessage=Send message
sendYourFeedbackToDrawIo=Send your feedback to draw io
separateSubProcess=Separate sub process
SequenceFlow=Sequence Flow
serviceUnavailableOrBlocked=Service unavailable or blocked
sessionExpired=Session expired
sessionTimeoutOnSave=Session timeout on save
setAsDefaultStyle=Set as default style
setAttributes=Set attributes
setModelAttribute=[]
setTheFileAsTopProcess=set the file as top process?
setTopProcess=Set top process
shadow=Shadow
shape=Shape
shapes=Shapes
shareBoard=Share the board
shareBoardManager=Board's sharing manager
shared=Shared
shareLink=Share link
sharingServerNotice=Sharing server notice
sharingServerReady=Sharing server ready
sharingServerUnavailable=Sharing server unavailable
sharp=Sharp
show=Show
showLR=Show learning resource
signOut=Sign out
simpleArrow=Simple arrow
singleRoleLearning=[]
size=Size
skill=[]
skilledUser=[]
softwaredesign=Software design
solid=Solid
SorryYouCan'tDeleteOther'sComment=Sorry you can't delete other's comment
sourceSpacing=Source spacing
south=South
spacing=Spacing
specialLink=Special link
startDebug=Start debug
starting=Starting
startTime=Start time
startTimeCanNotBeGreaterThanEndTime=Start time can not be greater than the end time, please reselect!
stopDebug=Stop debug
straight=Straight
strokeColor=Line color
style=Style
subjectPlusTooltip=Subject plus tooltip
submit=[]
subscript=Subscript
subTask=Sub-task
subTaskDes=Sub-task description
superscript=Superscript
support=Support
sureToSeparate=Sure to separate?
table=Table
targetSpacing=Target spacing
task=[]
taskGroup=Task group
taskGroupDes=Task group description
template=Template
templates=Templates
text=Text
textAlignment=Text alignment
textAreaEditor=[]
textAreaTemplate=[]
textOpacity=Text opacity
textType=Text type
theme=Theme
theToolUsed=[]
thing=[]
tilesView=Tiles view
timeAsc=Time asc
timeControl=[]
timeDesc=Time desc
timeout=Timeout
timeRange=Time range
tipsOfTheTask=[]
toBack=To back
toFront=To front
tool=Tool
tooltips=Tooltips
top=Top
topAlign=Top Align
transparent=Transparent
true=true
tryAgain=Try again
turn=Turn
typicalWorkTask=[]
typicalWorkTaskName=[]
unableToMoveDown=[]
unableToMoveUp=[]
unbindTypicalWorkTask=[]
undefined=Undefined
underline=Underline
undo=Undo
ungroup=Ungroup
unknownError=Unknown error
unmerge=Unmerge
unpublishTheCourse=Unpublish the course
unpublishTheCourseFromPlayer=[]
unsavedChanges=Unsaved changes
untitledDiagram=Untitled diagram
untitledLibrary=Untitled library
updatingDocument=Updating Document. Please wait...
updatingSelection=Updating Selection. Please wait...
upload/edit=[]
upload=Upload
uploadAMaterial=[]
uploadFile=[]
uploadImage=[]
uploadLearningEnvir=Upload learning environment
uploadMaterial=Upload material
uploadMaterialFirst=[]
uploadMaterials=Upload materials
url=URL
userControl=[]
UserTask=User Task
venndiagrams=Venndiagrams
version=Version
vertical=Vertical
verticalFlow=Vertical flow
verticalTree=Vertical tree
videoEdit=Video edit
view=View
virtualMachine=[]
waypoints=Waypoints
west=West
width=Width
wireframes=Wireframes
wordWrap=Word wrap
workbench=Workbench
workbenchFailToGetVMType=[]
workbenchFailToSave=[]
writingDirection=Writing direction
years=Years
yourEmailAddress=Your email address
zoom=Zoom
zoomIn=Zoom in
zoomOut=Zoom out